project	기획 계획 연구과제 계획하다 기획하다
reject	거부하다 거절하다
subject	학과 과목 주제 주어 복종시키다
adjust	조절하다 조정하다 적응하다
injure	상처를입히다 손상하다
judge	판사 판단하다 재판하다
justice	정의 공정
justify	정당성을증명하다
prejudice	편견 선입관 편견을갖게하다
labor	노동 노력 일하다
laboratory	연구소 실험실
elaborate	자세히말하다 정교한 공들인
collaboration	공동작업
lax	느슨한 헐거운 애매한
analysis	분석 분해
paralyze	마비시키다 무력하게하다
delay	지체 지연 늦추다 연기하다
collect	모으다 수집하다
elect	선출하가 선거하다
intellectual	지적인 지성의
neglect	부시하다 등한시하다 무시
lecture	강의 강의하다
legend	전설
elegant	우아한